Maksim Berezovski

Salvesta - сохрани

Lülita sisse - включи

Lülita välja - выключи

Laadi alla - скачай / laadi alla faili

Laadi üles - закачай - загрузи / faili laadi üles serverisse

kustuta - удалить

käivita - запуск

lohista - тяни, тащи / lohista faili

sisesta - введи / вставь

lisa - добавлять

kuva - отобрази

muuda - изменять

--------------

andmebaas - база данных

andmebaasihaldusüsteem - СУБД

versioonihaldussüsteem -... /gitHub - система контроля версий

väärtus - значение

tabel, rida, veerg

kirje / kirjed -запись

väli / väljad - поля

lause = päring - предложение / запрос

piirang - ограничение / UNIQUE, NOT NULL, PRIMARY KEY, FOREIGN KEY, CHECK

tulemus - результат

seos - связь

seosta tabelid - связать таблицы

veateade - сообщение об ошибке

suurus - размер / väljasuurus

andmetüüp - тип данных

arvtüüp - числовой тип

sümboltüüp - тип символа

loogiline tüüp - логический тип

kuupäev/aeg - дата/время

tabeli eemaldamine -DROP TABLE -удаление таблицы

veeru muutmine / lisame / eemaldamine - изменение столбца

tabeli loomine / luua tabelid -CREATE TABLE - создание таблицы

primaarne võti - Primaar Võti - основной ключ

välisvõti - Foreign Key - внешний ключ
